#######################################
# Syntax Coloring Map For chinScreen Library
#######################################

#######################################
# Datatypes (KEYWORD1)
#######################################

chinScreen	KEYWORD1
chinScreen_timer_t	KEYWORD1
chinScreen_anim_type_t	KEYWORD1
chinScreen_btn_callback_t	KEYWORD1
chinScreen_timer_callback_t	KEYWORD1
chinScreen_icon_t	KEYWORD1
chinScreen_sprite_t	KEYWORD1
chinScreen_gradient_stop	KEYWORD1
chinScreen_Video	KEYWORD1

#######################################
# Methods and Functions (KEYWORD2)
#######################################

# Display Initialization and Control
init_display	KEYWORD2
chinScreen_backlight	KEYWORD2
chinScreen_brightness	KEYWORD2
chinScreen_clear	KEYWORD2

# Background Functions
chinScreen_background_solid	KEYWORD2
chinScreen_background_gradient	KEYWORD2
chinScreen_background_multi_gradient	KEYWORD2
chinScreen_background_rainbow	KEYWORD2
chinScreen_background_preset_gradient	KEYWORD2
chinScreen_background_custom_gradient	KEYWORD2
chinScreen_background_positioned_gradient	KEYWORD2
chinScreen_init_screen_for_gradients	KEYWORD2
chinScreen_debug_screen_info	KEYWORD2

# Text Functions
chinScreen_text	KEYWORD2
getFontBySize	KEYWORD2

# Shape Functions
chinScreen_rectangle	KEYWORD2
chinScreen_circle	KEYWORD2
chinScreen_triangle	KEYWORD2
chinScreen_hexagon	KEYWORD2
chinScreen_oval	KEYWORD2
chinScreen_shape_text	KEYWORD2

# Icon Functions - Static PNG
chinScreen_icon	KEYWORD2
chinScreen_icon_colored	KEYWORD2
chinScreen_icon_red	KEYWORD2
chinScreen_icon_blue	KEYWORD2
chinScreen_icon_green	KEYWORD2
chinScreen_icon_white	KEYWORD2
chinScreen_icon_black	KEYWORD2
chinScreen_icon_yellow	KEYWORD2
chinScreen_icon_orange	KEYWORD2
chinScreen_icon_purple	KEYWORD2
chinScreen_icon_cyan	KEYWORD2
chinScreen_icon_magenta	KEYWORD2
chinScreen_icon_lime	KEYWORD2
chinScreen_icon_pink	KEYWORD2
chinScreen_icon_at	KEYWORD2
chinScreen_icon_positioned	KEYWORD2
chinScreen_icon_grid	KEYWORD2
chinScreen_icon_set_color	KEYWORD2
chinScreen_icon_set_color_advanced	KEYWORD2
chinScreen_icon_change_color	KEYWORD2
chinScreen_find_icon	KEYWORD2
chinScreen_list_available_icons	KEYWORD2

# Sprite Functions
chinScreen_sprite	KEYWORD2
chinScreen_find_sprite	KEYWORD2
chinScreen_list_available_sprites	KEYWORD2
chinScreen_sprite_change	KEYWORD2

# Input Controls
chinScreen_button	KEYWORD2
chinScreen_image_button	KEYWORD2
chinScreen_slider	KEYWORD2
chinScreen_slider_get_value	KEYWORD2
chinScreen_toggle	KEYWORD2
chinScreen_toggle_get_state	KEYWORD2
chinScreen_keyboard	KEYWORD2
chinScreen_keyboard_get_text	KEYWORD2
chinScreen_keyboard_close	KEYWORD2
chinScreen_numpad	KEYWORD2
chinScreen_numpad_get_result	KEYWORD2
chinScreen_numpad_get_int	KEYWORD2
chinScreen_numpad_get_float	KEYWORD2

# Animation Functions
chinScreen_animate	KEYWORD2
chinScreen_animate_advanced	KEYWORD2
chinScreen_is_animating	KEYWORD2
chinScreen_stop_animations	KEYWORD2

# Progress Bar
chinScreen_progress_bar	KEYWORD2
chinScreen_progress_set_value	KEYWORD2

# Timer System
chinScreen_timer_create	KEYWORD2
chinScreen_timer_delete	KEYWORD2
chinScreen_timer_set_period	KEYWORD2
chinScreen_timer_get_period	KEYWORD2
chinScreen_timer_pause	KEYWORD2
chinScreen_timer_resume	KEYWORD2
chinScreen_timer_is_running	KEYWORD2
chinScreen_timer_speed_up	KEYWORD2
chinScreen_timer_slow_down	KEYWORD2
chinScreen_repeat_every	KEYWORD2
chinScreen_call_after	KEYWORD2
chinScreen_timer_stop_all	KEYWORD2

# Media Functions
chinScreen_image	KEYWORD2
chinScreen_image_local	KEYWORD2
chinScreen_gif	KEYWORD2
chinScreen_gif_zoom	KEYWORD2
chinScreen_gif_animate_zoom	KEYWORD2
chinScreen_png	KEYWORD2
chinScreen_video_load	KEYWORD2
chinScreen_video_play	KEYWORD2
chinScreen_video_pause	KEYWORD2
chinScreen_video_stop	KEYWORD2
chinScreen_video_is_playing	KEYWORD2

# Utility Functions
chinScreen_set_position	KEYWORD2
chinScreen_delete_object	KEYWORD2
chinScreen_init_sd_card	KEYWORD2
chinScreen_preload_image	KEYWORD2
chinScreen_show_preloaded_image	KEYWORD2
chinScreen_task_handler	KEYWORD2

# Color Functions
getColorByName	KEYWORD2
getColorCount	KEYWORD2
getColorNameByIndex	KEYWORD2

# Debug Functions
create_ui	KEYWORD2

# Google Fonts (WIP)
chinScreen_load_google_font	KEYWORD2

#######################################
# Constants (LITERAL1)
#######################################

# Animation Types
ANIM_MOVE_X	LITERAL1
ANIM_MOVE_Y	LITERAL1
ANIM_SCALE	LITERAL1
ANIM_ROTATE	LITERAL1
ANIM_FADE	LITERAL1

# Font Sizes
FONT_SMALL	LITERAL1
FONT_MEDIUM	LITERAL1
FONT_LARGE	LITERAL1
FONT_XLARGE	LITERAL1

# Feature Enables
CHINSCREEN_ENABLE_SHAPES	LITERAL1
CHINSCREEN_ENABLE_MEDIA	LITERAL1
CHINSCREEN_ENABLE_ICONS	LITERAL1
CHINSCREEN_ENABLE_ANIMATED_ICONS	LITERAL1
CHINSCREEN_ENABLE_ANIMATIONS	LITERAL1
CHINSCREEN_ENABLE_EXAMPLES	LITERAL1
CHINSCREEN_ENABLE_DEBUG	LITERAL1
CHINSCREEN_ENABLE_GFONTS	LITERAL1
CHINSCREEN_ENABLE_SPRITES	LITERAL1

# Icon Enables - Static
CHINSCREEN_ICON_HOME	LITERAL1
CHINSCREEN_ICON_SETTINGS	LITERAL1
CHINSCREEN_ICON_USER	LITERAL1
CHINSCREEN_ICON_MENU	LITERAL1
CHINSCREEN_ICON_BACK	LITERAL1
CHINSCREEN_ICON_FORWARD	LITERAL1
CHINSCREEN_ICON_PLAY	LITERAL1
CHINSCREEN_ICON_PAUSE	LITERAL1
CHINSCREEN_ICON_STOP	LITERAL1
CHINSCREEN_ICON_VOLUME	LITERAL1
CHINSCREEN_ICON_POWER	LITERAL1
CHINSCREEN_ICON_BATTERY	LITERAL1
CHINSCREEN_ICON_SIGNAL	LITERAL1
CHINSCREEN_ICON_WIFI	LITERAL1
CHINSCREEN_ICON_DOWNLOAD	LITERAL1
CHINSCREEN_ICON_UPLOAD	LITERAL1
CHINSCREEN_ICON_REFRESH	LITERAL1
CHINSCREEN_ICON_DELETE	LITERAL1
CHINSCREEN_ICON_SAVE	LITERAL1
CHINSCREEN_ICON_EDIT	LITERAL1
CHINSCREEN_ICON_SEARCH	LITERAL1

# Icon Enables - Animated
CHINSCREEN_ICON_AVATAR	LITERAL1
CHINSCREEN_ICON_BOOK	LITERAL1
CHINSCREEN_ICON_CLOSED	LITERAL1
CHINSCREEN_ICON_GEAR	LITERAL1
CHINSCREEN_ICON_LOADING	LITERAL1
CHINSCREEN_ICON_OPEN	LITERAL1
CHINSCREEN_ICON_TOUCH	LITERAL1

# Sprite Enables
CHINSCREEN_SPRITE_MAN	LITERAL1

# Common Colors
black	LITERAL1
white	LITERAL1
red	LITERAL1
green	LITERAL1
blue	LITERAL1
yellow	LITERAL1
cyan	LITERAL1
magenta	LITERAL1
gray	LITERAL1
orange	LITERAL1
purple	LITERAL1
pink	LITERAL1
brown	LITERAL1
navy	LITERAL1
lime	LITERAL1

# Alignment Constants
top	LITERAL1
middle	LITERAL1
bottom	LITERAL1
left	LITERAL1
center	LITERAL1
right	LITERAL1

# Gradient Direction
horizontal	LITERAL1
vertical	LITERAL1
diagonal	LITERAL1

# Font Size Names
small	LITERAL1
medium	LITERAL1
large	LITERAL1
xlarge	LITERAL1

# Easing Types
linear	LITERAL1
ease_in	LITERAL1
ease_out	LITERAL1
ease_in_out	LITERAL1
bounce	LITERAL1

# Preset Gradient Names
sunset	LITERAL1
ocean	LITERAL1
fire	LITERAL1
rainbow	LITERAL1
warm	LITERAL1
cool	LITERAL1
full	LITERAL1
